##############################
#  #-  --- --- --- --- ---   #
#   ##  #     ##       #  ---#
#  #    #     ##      ### ---#
#  #  --#     ----## - #  ---#
#  -----####--####-- --# -- -#
#                         ---#
#    ####  C     - ---    ---#
#                -        ---#
#         ####   -           #
#                -      # ####
#             ----     # - % #
#                        ##--#
#                            #
##############################