###############################
#  #-  --- --- -#-- --- - %   #
#   ##  #     ## -      #  -- #
#  #    # --  ##   -   ### -- #
#  #  --#     ----##- - #  -- #
#  -----####--####-- ---# --  #
#    -            -   -- - -  #
#    ####  -     - --- #   -  #
#     #    -      -        -- #
#     #   -####   -        -  #
#     #----       -      # ####
#  ---#  -     ----     # - % #
#       C#                ##--#
#        #                    #
#                             #
###############################