##############################
#  #-  --- --- --- --- ---   #
#   ##  #     ##       #  ---#
#  #    #     ##      ### ---#
#  #  --#     ----## - #  ---#
# E-----####--####-- --# -- -#
#                  E      ---#
#   E#### C      - ---    ---#
#                -        ---#
#         ####   -           #
#                -      # ####
#         E   ----     # - % #
#                      E ##--#
#     E                      #
##############################